#;#;#;#;#;#;#;#;#;#;#;#;#;#;#;#;#;#;#;#;#;#;#;#;#;#;#;#;#;#;#;#;#;#;#;#;#;#;#;#;#;#;#;#;#;#;#;#;#;#;#;#;#;#;#;#;#;#;#;#;#;#;#;#;#;#;#;#;#;#;#;#;#;#;#;#;#;#;#;#
#;@;#;f;f;f;#;f;f;f;n;f;#;&;f;f;f;n;n;f;f;f;f;f;f;f;f;f;n;n;f;f;#;&;f;f;n;f;M;f;f;f;f;#;f;f;f;f;f;f;#;&;M;f;n;n;f;f;f;f;f;#;f;f;f;f;f;n;n;M;f;f;n;f;f;#;f;#;f;#
#;f;#;f;f;f;#;f;#;#;#;f;#;f;f;S;f;n;n;f;#;f;f;f;f;f;f;f;f;#;f;f;#;M;f;#;f;#;f;f;#;#;f;#;f;f;f;M;f;f;#;#;#;#;#;#;f;f;f;f;f;n;n;f;f;#;f;#;#;#;#;#;#;f;f;#;f;f;f;#
#;f;#;f;#;f;f;n;f;S;#;f;#;f;f;f;f;n;n;f;f;f;#;f;f;f;f;f;n;n;f;f;#;f;#;#;f;f;n;#;f;f;n;#;#;#;f;f;#;f;#;f;f;f;f;f;f;f;f;f;f;#;f;f;M;#;f;#;f;f;f;f;#;f;G;n;f;#;f;#
#;f;#;f;#;#;#;#;f;f;#;S;#;f;f;f;f;n;n;#;f;f;f;f;f;#;f;#;#;#;f;f;#;f;n;f;M;f;f;f;f;#;n;f;f;#;f;f;#;f;n;f;f;#;f;f;f;f;f;f;f;#;f;f;#;f;f;#;f;#;f;#;#;f;#;n;f;f;f;#
#;f;f;f;#;f;f;f;f;f;#;f;#;#;#;#;#;n;f;f;f;S;f;f;#;f;#;f;f;f;f;f;#;#;#;#;#;#;f;#;f;f;#;f;f;#;#;#;#;#;n;f;f;#;f;f;f;f;M;f;f;n;n;f;f;f;f;#;f;#;f;n;#;#;f;f;#;f;f;#
#;#;#;#;#;#;#;#;#;#;#;n;#;f;f;f;f;n;n;f;f;f;f;#;f;f;#;f;f;f;f;f;f;f;L;f;f;#;f;f;#;f;#;#;f;f;#;f;f;f;f;#;f;f;f;f;f;f;f;f;f;#;#;#;#;#;#;#;f;#;#;n;#;f;f;f;#;G;f;#
#;f;f;f;f;#;n;n;f;f;f;f;#;f;f;#;f;f;n;n;f;f;#;f;f;f;#;f;#;#;#;#;#;#;#;#;f;#;f;f;f;n;#;f;f;f;#;f;f;f;f;n;n;#;f;#;f;f;f;f;f;#;f;f;f;f;&;#;f;#;f;f;#;M;f;f;n;f;f;#
#;f;#;f;f;f;f;#;#;f;f;f;#;#;f;f;f;f;f;#;#;#;f;f;f;f;#;f;#;f;n;f;f;f;n;f;f;#;#;#;#;f;#;f;f;f;#;#;#;f;f;#;f;f;f;f;f;f;f;f;f;#;f;#;#;#;f;#;G;#;f;#;#;#;#;#;#;f;f;#
#;f;f;#;f;f;#;f;f;f;f;f;#;f;f;f;f;f;f;#;f;f;f;f;f;f;f;f;#;#;n;#;#;#;n;#;#;#;f;f;f;f;f;#;#;f;#;f;f;f;f;#;f;#;f;f;#;#;#;f;f;#;f;#;*;#;f;#;f;#;G;f;#;f;f;G;f;f;f;#
#;f;f;#;S;f;#;f;f;#;f;#;f;f;#;f;f;f;#;f;f;f;S;f;f;f;f;f;#;f;f;f;#;f;f;f;f;#;f;#;#;f;#;f;f;f;#;f;M;f;f;#;#;f;n;f;f;f;f;f;f;#;f;#;f;f;f;#;f;#;f;#;#;#;&;f;f;f;f;#
#;f;#;f;f;f;n;n;f;f;f;f;#;f;f;f;f;#;f;f;f;f;f;f;f;f;n;#;f;f;f;f;#;f;f;f;f;#;f;f;f;f;#;f;f;f;L;f;f;f;#;#;f;f;n;#;#;f;f;f;f;#;f;#;#;#;#;#;f;#;f;L;f;f;#;#;#;#;#;#
#;f;f;f;#;f;f;#;f;f;f;#;f;f;S;f;#;#;#;#;#;#;#;#;#;#;n;#;f;f;S;f;#;f;M;f;f;#;f;#;#;#;#;n;f;#;#;n;#;#;#;f;f;f;f;f;f;#;f;f;f;#;f;f;f;n;n;f;f;#;#;#;#;f;f;f;n;f;f;#
#;f;#;f;#;f;#;f;f;#;f;#;&;f;f;#;f;f;f;#;f;n;n;f;f;#;f;#;f;f;f;f;#;#;f;f;f;#;f;#;f;f;#;n;#;f;#;n;f;f;#;f;#;f;f;#;f;f;#;f;n;#;#;#;#;#;#;#;#;#;f;f;f;f;f;f;#;f;f;#
#;f;f;f;f;f;n;f;f;S;#;S;#;#;#;#;f;#;f;#;f;#;#;#;f;#;f;#;f;f;f;f;#;f;f;f;f;#;f;#;f;#;f;f;#;f;f;f;f;f;#;f;f;f;#;f;f;f;f;n;n;f;f;f;#;f;f;f;f;#;f;#;f;#;f;f;#;f;f;#
#;n;f;f;f;n;n;#;#;#;f;f;f;n;n;#;f;#;f;#;f;#;f;f;f;#;f;#;f;f;f;f;#;f;f;f;f;#;f;#;f;n;f;#;&;f;f;#;f;f;#;f;f;f;f;f;f;f;#;#;f;f;f;f;#;M;f;f;f;#;n;#;G;f;f;f;#;f;f;#
#;n;#;#;#;n;f;f;f;#;f;f;f;n;n;#;f;#;f;#;f;#;f;#;#;#;f;#;n;f;f;f;#;f;f;f;n;n;f;#;f;#;f;f;#;f;f;f;f;f;#;f;f;#;f;M;f;#;f;n;n;f;f;f;#;f;f;f;f;n;M;#;f;#;f;f;#;f;G;#
#;f;f;f;#;f;f;f;f;f;f;f;f;#;f;#;f;#;f;#;S;#;f;#;f;f;f;#;n;#;#;#;#;#;#;#;#;#;#;#;f;f;#;f;#;f;f;M;f;#;#;#;f;f;f;f;f;f;f;#;f;f;f;f;f;n;n;f;f;#;n;f;f;f;f;n;n;f;f;#
#;f;S;f;#;f;f;f;f;f;f;f;&;#;f;f;f;#;f;f;f;#;S;f;f;#;f;#;f;f;f;f;f;f;f;f;f;f;f;f;M;#;f;M;f;#;f;f;f;#;f;f;f;f;f;f;f;f;f;#;f;f;M;f;f;n;n;f;f;#;f;#;f;f;f;n;f;f;&;#
#;#;#;#;#;#;#;#;#;#;#;#;#;#;#;#;#;#;#;#;#;#;#;#;#;#;#;#;#;#;#;#;#;#;#;#;#;#;#;#;#;#;#;#;#;#;#;#;#;#;#;#;#;#;#;#;#;#;#;#;#;#;#;#;#;#;#;#;#;#;#;#;#;#;#;#;#;#;#;#
