#;#;#;#;#;#;#;#;#;#;#;#;#;#;#;#;#;#;#;#;#;#;#;#;#;#;#;#;#;#;#;#;#;#;#;#;#;#;#;#;#;#;#;#;#;#;#;#;#;#;#;#;#;#;#;#;#;#;#;#;#;#;#;#;#;#;#;#;#;#;#;#;#;#;#;#;#;#;#;#
#;f;f;f;f;f;f;f;f;#;f;f;f;f;f;f;f;#;f;f;f;f;f;f;&;#;f;&;#;&;f;f;n;f;f;f;n;f;f;C;f;f;#;f;f;f;#;f;f;f;#;f;f;f;#;f;f;f;#;f;f;f;f;f;f;f;f;f;f;f;f;n;f;f;f;f;f;f;f;#
#;f;f;f;f;f;f;W;&;#;f;f;f;f;W;f;f;#;f;f;f;f;f;f;f;#;W;f;f;#;f;f;#;f;f;#;#;#;f;f;f;f;#;f;#;f;#;f;f;f;#;f;#;f;#;f;f;f;#;f;f;#;X;f;#;#;#;#;#;#;#;f;f;f;#;n;#;#;f;#
#;f;#;#;#;#;#;#;#;#;f;f;f;f;f;f;f;#;f;f;W;f;f;f;f;#;f;f;f;#;f;C;#;f;f;f;#;#;#;#;n;n;#;f;#;f;#;n;#;f;#;f;#;f;n;f;f;f;#;f;#;#;#;#;#;f;f;f;f;f;#;#;#;f;#;f;f;n;f;#
#;f;f;f;n;f;f;#;&;f;f;f;f;f;f;f;f;#;#;#;#;#;#;n;#;#;f;f;f;f;#;f;#;f;C;#;f;f;n;#;f;f;#;f;#;f;#;f;#;f;#;f;#;f;#;f;f;C;#;f;n;f;f;f;f;f;f;f;f;f;f;f;#;f;n;f;f;#;f;#
#;#;#;#;#;f;f;#;#;#;#;#;#;#;#;n;#;#;f;f;f;f;f;f;f;#;f;f;f;#;f;f;#;f;#;f;f;#;C;#;f;C;#;n;#;C;f;f;#;f;#;f;#;n;#;f;f;f;#;f;#;f;f;f;f;X;f;f;f;f;f;&;#;f;#;f;X;#;f;#
#;f;f;f;f;f;f;f;f;f;f;f;f;f;f;f;f;f;f;f;f;f;f;f;f;f;#;f;f;#;n;#;#;n;#;f;f;#;n;#;f;f;#;f;#;#;#;#;#;f;#;f;#;C;#;f;f;&;#;f;#;#;#;#;#;#;#;#;#;#;#;#;#;f;#;#;n;#;f;#
#;f;#;f;f;f;f;f;f;f;f;f;f;f;f;W;f;f;#;#;f;f;f;f;f;f;f;n;#;f;f;f;f;f;f;f;f;#;n;#;f;&;#;f;#;f;n;f;f;f;#;f;#;f;#;#;#;#;#;f;#;f;f;#;f;f;f;f;#;f;f;n;f;f;f;f;f;f;f;#
#;n;#;#;#;#;#;#;#;#;#;#;#;#;#;#;#;#;#;#;#;#;#;#;#;#;#;#;#;#;#;#;#;#;#;#;#;#;f;#;#;#;#;f;#;f;#;f;C;f;#;f;#;f;#;f;f;f;#;f;#;f;f;#;f;f;#;f;#;f;#;#;f;f;f;X;f;f;f;#
#;f;f;f;f;f;f;f;f;G;f;f;f;f;f;f;f;f;f;f;f;f;G;f;f;f;f;f;f;f;f;f;n;n;G;n;n;f;@;f;n;n;M;f;#;C;#;f;f;f;#;f;#;f;#;f;f;f;#;f;#;f;f;n;X;f;#;&;#;f;#;#;#;#;#;#;#;#;#;#
#;#;n;#;#;#;#;#;#;#;#;#;#;#;#;#;#;#;#;#;#;#;#;#;#;#;#;#;#;#;#;#;#;#;#;#;#;#;f;#;#;#;#;f;#;f;#;#;#;f;#;f;#;f;#;#;n;#;#;f;#;f;#;#;#;#;#;#;#;f;n;f;f;f;f;f;f;f;f;#
#;f;f;f;f;f;f;n;f;f;f;f;f;W;f;f;f;f;f;n;f;f;f;f;f;f;&;#;f;f;f;f;f;f;f;f;f;#;n;#;f;f;#;n;f;f;#;f;#;f;L;f;#;f;n;f;f;f;f;f;#;f;f;f;f;f;f;f;#;f;#;f;#;#;#;#;#;#;f;#
#;f;f;f;f;#;#;#;#;#;#;#;#;#;#;#;f;f;f;f;n;f;f;f;W;f;#;f;f;f;f;f;#;#;#;#;f;#;n;#;f;f;#;#;#;#;#;f;#;#;#;#;#;#;#;#;#;#;#;#;#;#;#;#;f;f;f;f;#;f;#;f;f;f;f;X;f;f;f;#
#;#;f;f;f;f;f;f;f;f;f;f;f;f;f;#;#;#;#;#;#;f;f;f;f;#;f;#;#;#;#;n;#;f;f;f;f;#;M;#;W;f;f;#;f;f;f;f;f;f;#;f;f;f;f;f;f;f;f;#;f;f;f;#;#;#;#;f;#;f;#;f;#;#;#;#;#;#;#;#
#;&;#;f;f;W;f;f;f;f;f;f;f;#;f;f;n;f;f;f;n;n;n;f;#;f;f;f;f;f;f;f;#;f;#;#;#;#;n;#;f;#;n;#;f;f;f;f;f;f;f;f;f;W;f;f;f;f;f;f;#;#;f;f;X;f;f;f;#;f;#;n;#;f;n;f;f;f;f;#
#;f;f;#;f;f;f;f;#;n;#;n;#;#;#;#;f;f;f;f;f;f;f;#;f;f;f;f;W;f;f;f;#;f;f;f;f;f;f;#;f;#;f;f;n;f;f;f;f;f;#;f;f;f;f;f;f;f;f;f;f;f;#;f;#;#;#;#;#;f;#;L;#;f;#;#;#;#;X;#
#;f;f;#;n;#;#;n;#;f;f;f;f;#;f;f;f;#;W;f;f;f;#;f;f;#;#;#;#;#;#;n;#;#;#;#;#;#;#;#;f;#;f;f;#;#;#;#;#;#;#;#;#;#;#;#;#;#;#;#;#;n;#;n;n;f;f;f;#;f;#;f;#;f;#;f;L;f;f;#
#;f;f;W;f;f;f;f;#;f;W;f;f;#;#;#;#;#;f;f;f;f;f;#;#;f;f;f;f;f;f;f;#;n;f;f;#;f;f;f;f;#;f;#;f;f;f;f;f;f;f;f;f;f;f;f;f;f;#;f;f;f;f;#;f;f;X;f;#;f;#;f;#;f;#;X;#;#;#;#
#;f;f;f;f;f;f;f;#;f;f;f;f;f;f;f;f;f;f;f;f;f;&;#;f;f;f;W;f;f;f;f;L;f;#;f;f;f;#;f;f;#;f;n;f;f;f;f;f;f;#;f;f;f;f;W;f;f;f;#;f;W;&;#;f;f;f;f;f;f;#;f;X;f;#;f;f;f;*;#
#;#;#;#;#;#;#;#;#;#;#;#;#;#;#;#;#;#;#;#;#;#;#;#;#;#;#;#;#;#;#;#;#;#;#;#;#;#;#;#;#;#;#;#;#;#;#;#;#;#;#;#;#;#;#;#;#;#;#;#;#;#;#;#;#;#;#;#;#;#;#;#;#;#;#;#;#;#;#;#
