#;#;#;#;#;#;#;#;#;#;#;#;#;#;#;#;#;#;#;#;#;#;#;#;#;#;#;#;#;#;#;#;#;#;#;#;#;#;#;#;#;#;#;#;#;#;#;#;#;#;#;#;#;#;#;#;#;#;#;#;#;#;#;#;#;#;#;#;#;#;#;#;#;#;#;#;#;#;#;#
#;&;f;f;f;f;f;f;f;f;f;n;n;f;f;f;f;f;f;#;f;f;f;#;f;f;#;&;f;f;f;n;f;f;f;Z;f;f;f;f;f;f;n;f;f;f;n;f;f;f;f;f;f;f;f;f;f;f;f;f;f;f;f;Z;f;f;f;f;f;f;f;f;f;f;f;n;f;f;f;#
#;f;#;f;f;f;#;f;f;T;f;#;f;f;f;#;f;f;f;#;f;f;f;#;f;f;#;#;#;#;#;#;#;#;#;#;#;#;#;#;#;#;#;#;#;#;#;#;#;#;#;#;#;#;#;#;#;#;#;#;#;#;#;#;#;#;#;#;#;#;#;#;#;#;#;#;n;#;f;#
#;f;f;#;f;f;#;f;f;f;f;#;f;f;#;f;f;f;f;#;f;#;n;#;f;f;#;f;f;f;f;f;n;f;f;f;f;f;f;f;#;f;f;f;f;f;f;f;f;n;f;f;f;f;f;f;f;f;f;Z;f;f;f;#;f;f;f;f;f;#;f;f;f;f;f;f;f;#;f;#
#;f;f;f;#;f;f;f;#;#;n;n;f;f;f;f;T;f;f;n;f;#;f;f;X;f;#;f;f;f;f;f;#;f;f;f;f;f;f;f;#;f;f;f;f;Z;f;f;f;#;f;f;f;f;f;f;f;f;f;f;f;f;f;#;f;f;f;f;f;#;f;Z;f;f;f;f;f;#;f;#
#;T;f;n;n;#;f;#;f;f;n;#;#;#;#;#;#;#;#;#;f;#;f;f;f;f;#;f;f;f;f;f;#;f;f;f;f;f;f;f;#;f;f;f;f;f;f;f;f;#;#;#;#;#;#;#;#;#;#;f;f;f;f;#;f;f;f;f;f;#;f;f;f;f;f;f;f;#;f;#
#;f;f;n;n;f;#;f;f;#;f;#;f;f;f;f;f;f;&;#;f;#;f;#;#;n;#;#;#;f;Z;f;#;Z;f;f;f;f;f;f;#;#;#;#;#;#;#;#;n;#;f;f;f;f;f;f;f;f;#;f;f;f;f;#;f;f;f;Z;f;#;f;f;f;f;f;f;f;#;f;#
#;#;#;#;f;f;f;f;#;f;f;#;f;#;#;#;#;#;#;#;#;#;#;#;f;f;f;n;L;f;f;f;#;f;f;f;f;f;f;f;n;f;f;f;f;f;f;f;f;#;f;f;f;f;f;f;f;f;n;f;f;f;f;n;f;f;f;#;n;#;#;#;#;#;#;#;#;#;f;#
#;f;f;f;f;f;T;f;f;f;f;#;f;#;f;f;f;f;f;#;&;#;f;n;f;@;f;#;#;#;#;#;#;#;#;#;#;#;#;#;#;f;f;f;f;f;f;f;f;#;f;f;f;f;f;f;f;f;#;#;#;#;#;#;#;#;#;#;f;f;f;f;f;f;f;f;f;#;f;#
#;n;#;#;#;#;#;#;#;#;#;#;f;#;f;f;#;f;f;#;f;#;f;#;f;f;f;#;f;f;f;n;D;f;L;f;D;L;f;*;#;f;f;f;f;Z;f;f;f;#;f;f;f;f;Z;f;f;f;#;f;f;f;f;f;f;f;f;n;f;Z;f;f;f;f;f;f;f;#;f;#
#;f;f;f;f;f;f;T;f;f;f;f;f;#;f;f;#;f;f;#;f;#;f;#;f;f;f;n;f;f;f;f;#;#;#;#;#;#;#;#;#;#;#;#;#;#;#;#;#;#;#;#;#;#;#;#;#;#;#;n;#;#;#;#;#;#;#;#;#;#;#;#;#;#;#;#;#;#;f;#
#;#;#;#;#;#;#;#;#;#;#;#;#;#;f;f;#;f;T;#;f;#;f;#;#;#;#;#;f;D;f;f;#;f;f;f;f;f;f;f;#;f;f;f;f;f;f;f;f;f;f;n;f;f;f;f;f;f;#;f;#;f;f;f;f;f;f;#;f;f;f;f;f;f;f;f;f;#;f;#
#;f;f;f;n;f;f;f;f;f;f;f;n;n;f;f;#;f;f;f;f;#;f;f;f;f;T;#;f;f;f;f;#;f;f;f;f;Z;f;f;#;f;#;#;#;#;n;#;#;#;f;#;f;f;f;f;f;f;#;f;#;f;f;Z;f;f;f;#;f;#;#;n;#;#;#;#;f;#;f;#
#;f;f;f;#;f;#;#;#;#;#;#;#;#;#;#;#;#;#;#;#;#;#;#;#;#;f;#;#;#;#;#;#;f;f;f;f;f;f;f;#;f;#;f;f;f;f;f;f;#;f;#;Z;f;f;f;f;f;#;f;#;#;#;n;#;#;#;#;f;#;f;f;f;f;f;#;f;#;f;#
#;f;T;f;#;f;f;f;f;f;f;f;f;f;f;f;f;f;f;f;f;f;f;f;f;f;f;#;#;f;f;f;#;#;#;#;#;#;n;#;#;f;#;f;f;f;f;f;f;#;f;#;f;f;f;f;#;#;#;f;f;f;f;f;f;f;f;f;f;#;f;Z;f;f;f;#;f;#;f;#
#;f;f;f;#;#;#;#;#;#;#;#;#;#;#;#;#;#;#;#;#;#;#;#;#;#;#;&;#;f;f;f;n;f;f;f;f;f;f;f;f;f;#;f;f;f;Z;f;f;#;f;#;f;f;f;f;#;f;f;f;#;#;#;#;#;#;#;#;#;#;#;#;#;#;#;#;f;#;f;#
#;f;f;f;n;f;f;f;f;f;f;f;#;f;f;f;f;f;f;f;f;f;f;n;f;T;f;f;#;Z;f;f;#;#;#;#;#;#;n;#;#;#;#;f;f;f;f;f;f;#;f;#;f;f;f;f;n;f;#;f;#;f;f;Z;f;f;f;n;f;f;f;f;f;f;f;f;f;#;f;#
#;#;#;#;n;#;#;#;#;#;#;n;#;#;#;#;#;#;#;n;#;#;#;#;f;f;f;f;#;f;f;f;#;f;f;f;Z;f;f;f;#;f;f;f;f;f;f;f;f;n;f;#;#;#;#;#;#;f;#;f;#;f;f;f;f;f;f;#;#;#;#;#;#;#;#;#;#;#;f;#
#;f;f;T;f;f;#;f;f;f;f;f;T;f;f;n;f;f;T;f;f;f;f;#;f;f;f;f;#;&;f;f;#;f;f;f;f;f;f;f;#;f;f;f;f;f;f;f;f;#;f;f;f;f;f;f;f;f;#;f;#;f;f;f;f;f;f;n;f;f;f;f;f;f;f;f;f;f;f;#
#;#;#;#;#;#;#;#;#;#;#;#;#;#;#;#;#;#;#;#;#;#;#;#;#;#;#;#;#;#;#;#;#;#;#;#;#;#;#;#;#;#;#;#;#;#;#;#;#;#;#;#;#;#;#;#;#;#;#;#;#;#;#;#;#;#;#;#;#;#;#;#;#;#;#;#;#;#;#;#
