w,w,w,w,w,w,w,w,w,w,w,w,w,w,w,w,w,w,w,w
w,G,w,w,f,w,w,f,f,w,f,f,f,w,f,S,f,L,T,w
w,f,w,w,f,f,m,S,f,w,f,w,w,w,w,f,w,w,w,w
w,f,w,w,f,f,w,w,w,w,f,f,f,f,f,m,w,w,Q,w
w,f,w,w,f,f,f,w,w,w,f,f,w,w,w,m,m,w,S,w
w,f,w,w,m,m,f,f,f,f,f,f,w,w,w,f,w,w,f,w
w,f,w,w,f,f,w,w,f,f,w,w,f,w,w,S,f,w,m,w
w,f,w,w,S,f,w,w,f,f,w,w,f,w,w,m,m,f,f,w
w,f,f,m,f,f,w,w,f,f,w,w,f,f,f,f,f,f,f,w
w,w,w,w,w,w,w,w,w,w,w,w,w,w,w,w,w,w,w,w
