w;w;w;w;w;w;w;w;w;w;w;w;w;w;w;w;w;w;w;w
w;G;w;w;f;w;w;f;f;w;f;f;f;w;f;R;f;f;T;w
w;f;w;w;f;f;m;R;f;w;f;w;w;w;w;f;w;w;w;w
w;f;w;w;f;f;w;w;w;w;f;f;f;f;f;m;w;w;Q;w
w;f;w;w;f;f;f;w;w;w;f;f;w;w;w;m;m;w;R;w
w;f;w;w;m;m;f;f;f;f;f;f;w;w;w;f;w;w;f;w
w;f;w;w;f;f;w;w;f;f;w;w;f;w;w;R;;w;m;w
w;f;w;w;R;f;w;w;f;f;w;w;f;w;w;m;m;f;f;w
w;f;f;m;f;f;w;w;f;f;w;w;f;f;f;f;f;f;f;w
w;w;w;w;w;w;w;w;w;w;w;w;w;w;w;w;w;w;w;w
